AAACAAAC	AAACAAAC
AAACACGGT	AAACACGG
AAACACTATC	AAACACTA
AAACCGCCTCA	AAACCGCC
AAACGATC	AAACGATC
AAACGTGAT	AAACGTGA
AAACTACATC	AAACTACA
AAACTGTGTCA	AAACTGTG
AAAGAAAG	AAAGAAAG
AAAGAGGCT	AAAGAGGC
AAAGCCCGTC	AAAGCCCG
AAAGTCATTCA	AAAGTCAT
AAATAGCA	AAATAGCA
AAATTCCGT	AAATTCCG
AACAAATGTC	AACAAATG
AACAGAACTCA	AACAGAAC
AACAGCGG	AACAGCGG
AACGATTTT	AACGATTT
AACGCCAATC	AACGCCAA
AACGGTAGTCA	AACGGTAG
AACGTTAC	AACGTTAC
AACTCAGTT	AACTCAGT
AACTGCCTTC	AACTGCCT
AAGAACAGTCA	AAGAACAG
AAGAAGGT	AAGAAGGT
AAGAGTATT	AAGAGTAT
AAGCCTTCTC	AAGCCTTC
AAGCTCCTTCA	AAGCTCCT
AAGGATGA	AAGGATGA
AAGGCGCTT	AAGGCGCT
AAGGGACCTC	AAGGGACC
AAGTATTGTCA	AAGTATTG
AAGTCCAA	AAGTCCAA
AAGTCGGGT	AAGTCGGG
AAGTGAGATC	AAGTGAGA
AAGTTGTCTCA	AAGTTGTC
AATAAGGA	AATAAGGA
AATACATCT	AATACATC
AATATGACTC	AATATGAC
AATCCGGCTCA	AATCCGGC
AATCGAAG	AATCGAAG
AATCGTTCT	AATCGTTC
AATGGCGTTC	AATGGCGT
AATGTATGTCA	AATGTATG
ACAAAGAT	ACAAAGAT
ACAAGTAGT	ACAAGTAG
ACAATCTTTC	ACAATCTT
ACACCAAGTCA	ACACCAAG
ACAGATAA	ACAGATAA
ACAGGCCAT	ACAGGCCA
ACATCTCGTC	ACATCTCG
ACATGGACTCA	ACATGGAC
ACCAACCC	ACCAACCC
ACCAAGGGT	ACCAAGGG
ACCACAGATC	ACCACAGA
ACCAGTTTTCA	ACCAGTTT
ACCCATGC	ACCCATGC
ACCCGATTT	ACCCGATT
ACCCTCAATC	ACCCTCAA
ACCGTCGATCA	ACCGTCGA
ACCTGAAG	ACCTGAAG
ACCTTCCCT	ACCTTCCC
ACGAATTCTC	ACGAATTC
ACGACGACTCA	ACGACGAC
ACGCTTAA	ACGCTTAA
ACGGAGCAT	ACGGAGCA
ACGGCAGTTC	ACGGCAGT
ACGGGTTATCA	ACGGGTTA
ACGGTTGG	ACGGTTGG
ACGTAAACT	ACGTAAAC
ACTAATTGTC	ACTAATTG
ACTACCCGTCA	ACTACCCG
ACTAGAGC	ACTAGAGC
ACTCATACT	ACTCATAC
ACTCGGAATC	ACTCGGAA
ACTGCTGGTCA	ACTGCTGG
ACTGGTCA	ACTGGTCA
ACTTCGCTT	ACTTCGCT
AGAAACCATC	AGAAACCA
AGAAAGTGTCA	AGAAAGTG
AGAAGCTT	AGAAGCTT
AGAATCAAT	AGAATCAA
AGACCTCATC	AGACCTCA
AGACGAGGTCA	AGACGAGG
AGAGAGAC	AGAGAGAC
AGAGGTGCT	AGAGGTGC
AGCAACGCTC	AGCAACGC
AGCACGTATCA	AGCACGTA
AGCATGCC	AGCATGCC
AGCCATCTT	AGCCATCT
AGCGTGGTTC	AGCGTGGT
AGCTCCACTCA	AGCTCCAC
AGCTTCGA	AGCTTCGA
AGGACACAT	AGGACACA
AGGAGTCGTC	AGGAGTCG
AGGCAATATCA	AGGCAATA
AGGCCGAA	AGGCCGAA
AGGCGTTTT	AGGCGTTT
AGGGACTGTC	AGGGACTG
AGGGTAAATCA	AGGGTAAA
AGGTAAGC	AGGTAAGC
AGGTATATT	AGGTATAT
AGGTTCCCTC	AGGTTCCC
AGTAATGGTCA	AGTAATGG
AGTAGTTA	AGTAGTTA
AGTCACAAT	AGTCACAA
AGTCCGTGTC	AGTCCGTG
AGTGCTTCTCA	AGTGCTTC
AGTTGAAC	AGTTGAAC
AGTTGCGGT	AGTTGCGG
AGTTTGTATC	AGTTTGTA
ATAACAGGTCA	ATAACAGG
ATAAGCTA	ATAAGCTA
ATACACCCT	ATACACCC
ATACTCTCTC	ATACTCTC
ATAGATGTTCA	ATAGATGT
ATATGCAA	ATATGCAA
ATATGGGTT	ATATGGGT
ATCAATCGTC	ATCAATCG
ATCAGGGATCA	ATCAGGGA
ATCCCACC	ATCCCACC
ATCCGCATT	ATCCGCAT
ATCCTAGTTC	ATCCTAGT
ATCGCGCTTCA	ATCGCGCT
ATCGTAAC	ATCGTAAC
ATCTTGGCT	ATCTTGGC
ATGACAACTC	ATGACAAC
ATGACTTGTCA	ATGACTTG
ATGCATAT	ATGCATAT
ATGCGGAGT	ATGCGGAG
ATGGGCTCTC	ATGGGCTC
ATGGTCTGTCA	ATGGTCTG
ATGTGCCG	ATGTGCCG
ATTACCTTT	ATTACCTT
ATTATTCGTC	ATTATTCG
ATTCTGAGTCA	ATTCTGAG
ATTGAAGT	ATTGAAGT
ATTGGCCCT	ATTGGCCC
ATTTCCATTC	ATTTCCAT
ATTTGTTGTCA	ATTTGTTG
CAAACATT	CAAACATT
CAACGCAGT	CAACGCAG
CAAGGAATTC	CAAGGAAT
CAAGGGTTTCA	CAAGGGTT
CAAGGTAC	CAAGGTAC
CAATCTAGT	CAATCTAG
CAATTCTCTC	CAATTCTC
CACAACCTTCA	CACAACCT
CACAAGTA	CACAAGTA
CACTAACCT	CACTAACC
CACTTGATTC	CACTTGAT
CAGACTCGTCA	CAGACTCG
CAGATGGG	CAGATGGG
CAGGTTGCT	CAGGTTGC
CAGTTTAATC	CAGTTTAA
CATGACGATCA	CATGACGA
CATGCTGC	CATGCTGC
CATTCATTT	CATTCATT
CATTCGGGTC	CATTCGGG
CATTTCTATCA	CATTTCTA
CCACCTCT	CCACCTCT
CCACGTTGT	CCACGTTG
CCAGACAGTC	CCAGACAG
CCAGCGAATCA	CCAGCGAA
CCATATGA	CCATATGA
CCATCCACT	CCATCCAC
CCATCGTCTC	CCATCGTC
CCATGCATTCA	CCATGCAT
CCCGTAAG	CCCGTAAG
CCCGTTCTT	CCCGTTCT
CCCTCTTGTC	CCCTCTTG
CCCTGTTTTCA	CCCTGTTT
CCCTTGCA	CCCTTGCA
CCGACTTTT	CCGACTTT
CCGAGATCTC	CCGAGATC
CCGATACGTCA	CCGATACG
CCGGAAAT	CCGGAAAT
CCGTAGCTT	CCGTAGCT
CCGTCTTATC	CCGTCTTA
CCTACGCTTCA	CCTACGCT
CCTATTTA	CCTATTTA
CCTCATGAT	CCTCATGA
CCTTTACATC	CCTTTACA
CCTTTGTCTCA	CCTTTGTC
CGAAACTC	CGAAACTC
CGAACCGAT	CGAACCGA
CGAAGAAGTC	CGAAGAAG
CGACATTTTCA	CGACATTT
CGAGGCTA	CGAGGCTA
CGATCCAAT	CGATCCAA
CGATGGCATC	CGATGGCA
CGGACTAATCA	CGGACTAA
CGGCTGTA	CGGCTGTA
CGGTGAGTT	CGGTGAGT
CGTACCGATC	CGTACCGA
CGTCGAATTCA	CGTCGAAT
CGTGCAAC	CGTGCAAC
CGTGGGATT	CGTGGGAT
CGTGTACATC	CGTGTACA
CGTGTGTTTCA	CGTGTGTT
CGTTGCCT	CGTTGCCT
CGTTTCGTT	CGTTTCGT
CTAACGCCTC	CTAACGCC
CTACGGGATCA	CTACGGGA
CTAGACTA	CTAGACTA
CTAGCACGT	CTAGCACG
CTAGTAGGTC	CTAGTAGG
CTCAAACATCA	CTCAAACA
CTCACATC	CTCACATC
CTCCCAAAT	CTCCCAAA
CTCCTCCATC	CTCCTCCA
CTCGGTGATCA	CTCGGTGA
CTCTATAG	CTCTATAG
CTCTGCGTT	CTCTGCGT
CTGAAGGGTC	CTGAAGGG
CTGAGCGTTCA	CTGAGCGT
CTGCGATG	CTGCGATG
CTGCTAGAT	CTGCTAGA
CTGGAACATC	CTGGAACA
CTGGGTATTCA	CTGGGTAT
CTGTCGCA	CTGTCGCA
CTGTGACCT	CTGTGACC
CTGTTAAATC	CTGTTAAA
CTGTTGTGTCA	CTGTTGTG
CTGTTTCC	CTGTTTCC
CTTAGGCCT	CTTAGGCC
CTTAGTGTTC	CTTAGTGT
CTTCTACGTCA	CTTCTACG
CTTTATCC	CTTTATCC
CTTTCACTT	CTTTCACT
CTTTGGACTC	CTTTGGAC
GAAAGACATCA	GAAAGACA
GAAATACG	GAAATACG
GAAGATATT	GAAGATAT
GAATCCCATC	GAATCCCA
GAATGCGCTCA	GAATGCGC
GACACAAA	GACACAAA
GACACCTGT	GACACCTG
GACTAGCGTC	GACTAGCG
GAGAAACCTCA	GAGAAACC
GAGCGGAA	GAGCGGAA
GAGGAGTGT	GAGGAGTG
GAGGGTCATC	GAGGGTCA
GAGTGTACTCA	GAGTGTAC
GATACGCA	GATACGCA
GATGCAGAT	GATGCAGA
GATGGTTATC	GATGGTTA
GATGTGGCTCA	GATGTGGC
GATTAAAG	GATTAAAG
GATTACTTT	GATTACTT
GATTGGGATC	GATTGGGA
GATTTCCCTCA	GATTTCCC
GCAAACTG	GCAAACTG
GCACTCAGT	GCACTCAG
GCATCACTTC	GCATCACT
GCATCGAGTCA	GCATCGAG
GCCAAAGC	GCCAAAGC
GCCAACATT	GCCAACAT
GCCTGGTATC	GCCTGGTA
GCCTTGTGTCA	GCCTTGTG
GCGCTGAT	GCGCTGAT
GCGGTAACT	GCGGTAAC
GCGTATTCTC	GCGTATTC
GCGTGCAATCA	GCGTGCAA
GCTAAGTT	GCTAAGTT
GCTACCGTT	GCTACCGT
GCTATGGGTC	GCTATGGG
GCTCGTAGTCA	GCTCGTAG
GCTTCTCC	GCTTCTCC
GGAACGAAT	GGAACGAA
GGAAGTCCTC	GGAAGTCC
GGACTGGATCA	GGACTGGA
GGACTTCT	GGACTTCT
GGAGGTTTT	GGAGGTTT
GGAGTAAGTC	GGAGTAAG
GGATTGTTTCA	GGATTGTT
GGCAAGGT	GGCAAGGT
GGCACTTCT	GGCACTTC
GGCCCAATTC	GGCCCAAT
GGCGACAATCA	GGCGACAA
GGCTATAA	GGCTATAA
GGCTTTGCT	GGCTTTGC
GGGAGATGTC	GGGAGATG
GGGATTACTCA	GGGATTAC
GGGCATCA	GGGCATCA
GGGTCATTT	GGGTCATT
GGGTCTAGTC	GGGTCTAG
GGTAAATCTCA	GGTAAATC
GGTAGCCA	GGTAGCCA
GGTCCTAAT	GGTCCTAA
GGTCTTTCTC	GGTCTTTC
GGTGTCGATCA	GGTGTCGA
GGTTACAC	GGTTACAC
GGTTAGGGT	GGTTAGGG
GGTTGAGATC	GGTTGAGA
GTAAACAATCA	GTAAACAA
GTAAGCCG	GTAAGCCG
GTAATCTGT	GTAATCTG
GTACGCTTTC	GTACGCTT
GTACGGACTCA	GTACGGAC
GTATACGT	GTATACGT
GTATTGACT	GTATTGAC
GTCAAGAGTC	GTCAAGAG
GTCAGACCTCA	GTCAGACC
GTCAGGTT	GTCAGGTT
GTCCACTAT	GTCCACTA
GTCCGTCATC	GTCCGTCA
GTCCTTGCTCA	GTCCTTGC
GTCTAATC	GTCTAATC
GTCTGGAAT	GTCTGGAA
GTCTTCCTTC	GTCTTCCT
GTGAACTCTCA	GTGAACTC
GTGAGGCA	GTGAGGCA
GTGATAAAT	GTGATAAA
GTGCCCATTC	GTGCCCAT
GTGCGAAGTCA	GTGCGAAG
GTGGTGCT	GTGGTGCT
GTGTCACCT	GTGTCACC
GTGTCAGGTC	GTGTCAGG
GTTACTAGTCA	GTTACTAG
GTTCTGCT	GTTCTGCT
GTTGTCCGT	GTTGTCCG
TAAACCGATC	TAAACCGA
TAACTTCTTCA	TAACTTCT
TAAGGGCC	TAAGGGCC
TAATCCATT	TAATCCAT
TAATGTGGTC	TAATGTGG
TACCCTGCTCA	TACCCTGC
TACCGCTC	TACCGCTC
TACCTAAGT	TACCTAAG
TACCTCCCTC	TACCTCCC
TACGCGAGTCA	TACGCGAG
TACGTTCG	TACGTTCG
TACTGAATT	TACTGAAT
TAGATCAATC	TAGATCAA
TAGCCACATCA	TAGCCACA
TAGCGGAT	TAGCGGAT
TAGGCTTTT	TAGGCTTT
TAGGTACGTC	TAGGTACG
TAGTAGCCTCA	TAGTAGCC
TAGTCTCT	TAGTCTCT
TATCCACGT	TATCCACG
TATCTGTCTC	TATCTGTC
TATGTGAATCA	TATGTGAA
TATTAGCG	TATTAGCG
TCAAATGGT	TCAAATGG
TCAAGGCGTC	TCAAGGCG
TCAGCCTCTCA	TCAGCCTC
TCATACCA	TCATACCA
TCATAGCTT	TCATAGCT
TCATTTCATC	TCATTTCA
TCCAGAAGTCA	TCCAGAAG
TCCCTGGA	TCCCTGGA
TCCGACACT	TCCGACAC
TCCGCTGTTC	TCCGCTGT
TCCTATATTCA	TCCTATAT
TCGACTGC	TCGACTGC
TCGAGTTTT	TCGAGTTT
TCGCAATCTC	TCGCAATC
TCGGTCATTCA	TCGGTCAT
TCGTGGGT	TCGTGGGT
TCGTTCCCT	TCGTTCCC
TCTAAACTTC	TCTAAACT
TCTATTCCTCA	TCTATTCC
TCTGATTT	TCTGATTT
TCTTTGACT	TCTTTGAC
TGAATAGGTC	TGAATAGG
TGAATCCTTCA	TGAATCCT
TGACGTCG	TGACGTCG
TGAGAGCGT	TGAGAGCG
TGAGCACATC	TGAGCACA
TGCACCAGTCA	TGCACCAG
TGCCGGTA	TGCCGGTA
TGCGACTAT	TGCGACTA
TGCTGACGTC	TGCTGACG
TGCTTCATTCA	TGCTTCAT
TGCTTGGG	TGCTTGGG
TGGAAAGCT	TGGAAAGC
TGGACGGATC	TGGACGGA
TGGCTAGTTCA	TGGCTAGT
TGGGAATT	TGGGAATT
TGGTGTCTT	TGGTGTCT
TGGTTAACTC	TGGTTAAC
TGTTATCATCA	TGTTATCA
